abominable — отвратительный [əˈbɒmɪnəbl̩]
agitated — взволнованный [ˈædʒɪteɪtɪd]
angry, cross — сердитый [ˈæŋɡri, krɒs]
angst-ridden — испуганный[æŋst ˈrɪdn̩]
appalled — напуганный, потрясенный[əˈpɔːld]
astonished — изумленный[əˈstɒnɪʃt]
awed — трепещущий [ɔːd]
awful, terrible — ужасный [ˈɔːfl̩, ˈterəbl̩]
bad — плохой [bæd]
beautiful, lovely — красивый [ˈbjuːtəfl̩, ˈlʌvli]
bored — скучающий [bɔːd]
boring — надоедливый [ˈbɔːrɪŋ]
cheerful — веселый [ˈtʃɪəfəl]
cheery, mirthful — радостный [ˈtʃɪəri, ˈmɜːθfəl]
contented — довольный [kənˈtentɪd]
dangerous — опасный [ˈdeɪndʒərəs]
dejected — угнетенный [dɪˈdʒektɪd]
delightful — восхищенный, удовлетворенный [dɪˈlaɪtfəl]
disgusting, unpleasant — неприятный [dɪsˈɡʌstɪŋ, ʌnˈpleznt]
distressed — расстроенный [dɪˈstrest]
disturbing — тревожный / вызывающий беспокойство [dɪˈstɜːbɪŋ]
doubtful — сомневающийся [ˈdaʊtfʊl]
dreamy — мечтательный, витающий в облаках [ˈdriːmi]
excellent — отличный [ˈeksələnt]
excited — возбужденный [ɪkˈsaɪtɪd]
excited, agitated, uneasy — взволнованный [ɪkˈsaɪtɪd, ˈædʒɪteɪtɪd, ʌnˈiːzi]
exciting, moving — волнующий [ɪkˈsaɪtɪŋ, ˈmuːvɪŋ]
fearful — страшный, испуганный, боящийся  [ˈfɪəfəl]
frightened — напуганный [ˈfraɪtn̩d]
frightened, scared — испуганный [ˈfraɪtn̩d, skeəd]
fuming — яростный [ˈfjuːmɪŋ]
giggly — хихикающий [ˈɡɪɡli]
glad — довольный [ɡlæd]
good — хороший [ɡʊd]
guilty — виноватый [ˈɡɪlti]
haggard — изможденный [ˈhæɡəd]
handsome — симпатичный (о мужчине) [ˈhænsəm]
happy — счастливый [ˈhæpi]
high-spirited — в хорошем настроении [haɪ ˈspɪrɪtɪd]
horrified — напуганный [ˈhɒrɪfaɪd]
hurt — обиженный [hɜːt]
hysterical — истеричный [hɪˈsterɪkl̩] 
infuriated — разъяренный [ɪnˈfjʊərɪeɪtɪd]
insulting, abusive, offensive — оскорбительный [ɪnˈsʌltɪŋ, əˈbjuːsɪv, əˈfensɪv]
interesting — интересный [ˈɪntrəstɪŋ]
joyful, merry — радостный [ˈdʒɔɪfəl, ˈmeri]
lovey-dovey — шаловливый, игривый, влюбленный (AmE) [dəˈveɪ]
low-spirited — в плохом настроении [ləʊ ˈspɪrɪtɪd]
lucky — везучий [ˈlʌki]
moved — растроганный [muːvd]
nice — милый [naɪs] 
normal — обычный [ˈnɔːml̩]
offended — оскорбленный [əˈfendɪd]
optimistic — оптимистический [ˌɒptɪˈmɪstɪk]
peevish — сварливый [ˈpiːvɪʃ]
perfect — совершенный [pəˈfekt]
pessimistic — пессимистический [ˌpesɪˈmɪstɪk]
pleasant, agreeable — приятный [ˈpleznt, əˈɡriːəbl̩]
pretty, attractive — привлекательный [ˈprɪti, əˈtræktɪv]
repulsive — отталкивающий [rɪˈpʌlsɪv]
sad — печальный [sæd]
sarcastic — саркастический, язвительный [sɑːˈkæstɪk]
satisfied — удовлетворенный [ˈsætɪsfaɪd]
self-disgusted — вызывающий отвращение к себе [self dɪsˈɡʌstɪd]
shocked — шокированный [ʃɒkt]
shocking — шокирующий [ˈʃɒkɪŋ]
sorrowful — горестный [ˈsɒrəʊfl̩]
sorry — огорченный [ˈsɒri]
splendid, gorgeous, magnificent — великолепный  [ˈsplendɪd, ˈɡɔːdʒəs, mæɡˈnɪfɪsnt]
startled — пораженный, сильно удивленный [ˈstɑːtl̩d]
strange — странный [streɪndʒ]
stuffed — объевшийся [stʌft]
stunned — ошеломленый [stʌnd]
superior — превосходный [suːˈpɪərɪə]
surprised — удивленный [səˈpraɪzd]
surprised, astonished, amazed — удивленный [səˈpraɪzd, əˈstɒnɪʃt, əˈmeɪzd]
surprising, astonishing, amazing — удивительный [səˈpraɪzɪŋ, əˈstɒnɪʃɪŋ, əˈmeɪzɪŋ] 
terrified — испуганный [ˈterɪfaɪd]
tiresome — скучный [ˈtaɪəsəm]
touching — трогательный[ˈtʌtʃɪŋ]
ugly — безобразный [ˈʌɡli]
unattractive — непривлекательный [ˌʌnəˈtræktɪv]
unhappy — несчастливый [ʌnˈhæpi]
upset — расстроенный [ˌʌpˈset]
wonderful — чудесный [ˈwʌndəfəl]
woozy — одурманенный [ˈwuːzi]
worried — обеспокоенный [ˈwʌrɪd]отвратительный  — abominable [əˈbɒmɪnəbl̩]
взволнованный  — agitated [ˈædʒɪteɪtɪd]
сердитый  — angry, cross [ˈæŋɡri, krɒs]
испуганный — angst-ridden [æŋst ˈrɪdn̩]
напуганный, потрясенный — appalled [əˈpɔːld]
изумленный — astonished [əˈstɒnɪʃt]
трепещущий  — awed [ɔːd]
ужасный  — awful, terrible [ˈɔːfl̩, ˈterəbl̩]
плохой  — bad [bæd]
красивый  — beautiful, lovely [ˈbjuːtəfl̩, ˈlʌvli]
скучающий  — bored [bɔːd]
надоедливый  — boring [ˈbɔːrɪŋ]
веселый  — cheerful [ˈtʃɪəfəl]
радостный  — cheery, mirthful [ˈtʃɪəri, ˈmɜːθfəl]
довольный  — contented [kənˈtentɪd]
опасный  — dangerous [ˈdeɪndʒərəs]
угнетенный  — dejected [dɪˈdʒektɪd]
восхищенный, удовлетворенный  — delightful [dɪˈlaɪtfəl]
неприятный  — disgusting, unpleasant [dɪsˈɡʌstɪŋ, ʌnˈpleznt]
расстроенный  — distressed [dɪˈstrest]
тревожный / вызывающий беспокойство  — disturbing [dɪˈstɜːbɪŋ]
сомневающийся  — doubtful [ˈdaʊtfʊl]
мечтательный, витающий в облаках  — dreamy [ˈdriːmi]
отличный  — excellent [ˈeksələnt]
возбужденный  — excited [ɪkˈsaɪtɪd]
взволнованный  — excited, agitated, uneasy [ɪkˈsaɪtɪd, ˈædʒɪteɪtɪd, ʌnˈiːzi]
волнующий  — exciting, moving [ɪkˈsaɪtɪŋ, ˈmuːvɪŋ]
страшный, испуганный, боящийся   — fearful [ˈfɪəfəl]
напуганный  — frightened [ˈfraɪtn̩d]
испуганный  — frightened, scared [ˈfraɪtn̩d, skeəd]
яростный  — fuming [ˈfjuːmɪŋ]
хихикающий  — giggly [ˈɡɪɡli]
довольный  — glad [ɡlæd]
хороший  — good [ɡʊd]
виноватый  — guilty [ˈɡɪlti]
изможденный  — haggard [ˈhæɡəd]
симпатичный (о мужчине)  — handsome [ˈhænsəm]
счастливый  — happy [ˈhæpi]
в хорошем настроении  — high-spirited [haɪ ˈspɪrɪtɪd]
напуганный  — horrified [ˈhɒrɪfaɪd]
обиженный  — hurt [hɜːt]
истеричный  — hysterical [hɪˈsterɪkl̩]
разъяренный  — infuriated [ɪnˈfjʊərɪeɪtɪd]
оскорбительный  — insulting, abusive, offensive [ɪnˈsʌltɪŋ, əˈbjuːsɪv, əˈfensɪv]
интересный  — interesting [ˈɪntrəstɪŋ]
радостный  — joyful, merry [ˈdʒɔɪfəl, ˈmeri]
шаловливый, игривый, влюбленный (AmE)  — lovey-dovey [dəˈveɪ]
в плохом настроении  — low-spirited [ləʊ ˈspɪrɪtɪd]
везучий  — lucky [ˈlʌki]
растроганный  — moved [muːvd]
милый  — nice [naɪs]
обычный  — normal [ˈnɔːml̩]
оскорбленный  — offended [əˈfendɪd]
оптимистический  — optimistic [ˌɒptɪˈmɪstɪk]
сварливый  — peevish [ˈpiːvɪʃ]
совершенный  — perfect [pəˈfekt]
пессимистический  — pessimistic [ˌpesɪˈmɪstɪk]
приятный  — pleasant, agreeable [ˈpleznt, əˈɡriːəbl̩]
привлекательный  — pretty, attractive [ˈprɪti, əˈtræktɪv]
отталкивающий  — repulsive [rɪˈpʌlsɪv]
печальный  — sad [sæd]
саркастический, язвительный  — sarcastic [sɑːˈkæstɪk]
удовлетворенный  — satisfied [ˈsætɪsfaɪd]
вызывающий отвращение к себе  — self-disgusted [self dɪsˈɡʌstɪd]
шокированный  — shocked [ʃɒkt]
шокирующий  — shocking [ˈʃɒkɪŋ]
горестный  — sorrowful [ˈsɒrəʊfl̩]
огорченный  — sorry [ˈsɒri]
великолепный   — splendid, gorgeous, magnificent [ˈsplendɪd, ˈɡɔːdʒəs, mæɡˈnɪfɪsnt]
пораженный, сильно удивленный  — startled [ˈstɑːtl̩d]
странный  — strange [streɪndʒ]
объевшийся  — stuffed [stʌft]
ошеломленый  — stunned [stʌnd]
превосходный  — superior [suːˈpɪərɪə]
удивленный  — surprised [səˈpraɪzd]
удивленный  — surprised, astonished, amazed [səˈpraɪzd, əˈstɒnɪʃt, əˈmeɪzd]
удивительный  — surprising, astonishing, amazing [səˈpraɪzɪŋ, əˈstɒnɪʃɪŋ, əˈmeɪzɪŋ]
испуганный  — terrified [ˈterɪfaɪd]
скучный  — tiresome [ˈtaɪəsəm]
трогательный — touching [ˈtʌtʃɪŋ]
безобразный  — ugly [ˈʌɡli]
непривлекательный  — unattractive [ˌʌnəˈtræktɪv]
несчастливый  — unhappy [ʌnˈhæpi]
расстроенный  — upset [ˌʌpˈset]
чудесный  — wonderful [ˈwʌndəfəl]
одурманенный  — woozy [ˈwuːzi]
обеспокоенный  — worried [ˈwʌrɪd]
